##############
#............#
#..1......L..#
#............#
#............#
#............#
#..L.....2...#
#............#
##############