##############
#............#
#..1.........#
#............#
#............#
#............#
#........2...#
#............#
##############