##############
#............#
#..1...#L.#..#
#.#...#...#..#
#...#L#......#
#.#........#.#
#..#.L#..2...#
#............#
##############