##############
#............#
#..1...#..#..#
#.#...#...#..#
#...#.#......#
#.#........#.#
#..#..#..2...#
#............#
##############